11111111111111111
1E000010C000000C1
10100111010000001
1010S110101010101
1P000000000S00001
11111111111111111