11111111111111111
1P000010C0E0000C1
10100111011000001
10110S11001010101
100S0000000S00001
11111111111111111