11111111111111111111111111
10000000000000000000000001
1000P000000000000000000001
10000000000000000000000001
1000000000000000S000000001
10000000000000000000000001
10000010C1E0000C0000000001
10100111011000010000000001
1S110011001010100000000001
10000000000000000000000001
11111111111111111111111111