11111111111111111
10000010C000000C1
10100111010000001
1010S110101010101
1P000000000S000E1
11111111111111111